11111
100P1
10101
1C0X1
1E001
1X101
110C1
1X101
11111