1111111111
100C01C001
1100010001
11010P0011
1C01C0E0C1
1111111111