11111111111111
1C000CC0000001
100X1C100101C1
1X00CC0E1000P1
11111111111111