1111111111111
10000000000C1
1011C11111001
1P1011E000001
1111111111111