111111
1C10C1
101P01
10C0E1
111111