11111111111111111111111111111111111111111111111111111111111111111111111111111111111111111111111111111111111111111111111111111111111111111111111111111111
1000000000000000000000C000000000000100001000000000000000000000000000000000000000000000000000000000000000000000000000000000000000000000000000000000000001
10000001000000100000001000000000000001000001000000000000000000000000000000000000000000000000000000000000000000000000000000000000000000000000000000000001
1E1100001000111C000000110000000100101010100000X000000000000000000000000000000000000000000000000000000000000000000000000000000000000000000000000000000001
111100001010010C01P10100000000000X0000000011100000000000000000000000000000000000000000000000000000000000000000000000000000000000000000000000000000000001
10000010010001000100001001010000100101000010000000000000000000000000000000000000000000000000000000000000000000000000000000000000000000000000000000000001
10010101010000000010101000000010000000000001010000000000000000000000000000000000000000000000000000000000000000000000000000000000000000000000000000000001
11111111111111111111111111111111111111111111111111111111111111111111111111111111111111111111111111111111111111111111111111111111111111111111111111111111