1111111111111
10000000000C1
1011C000110X1
1P10110E000X1
1111111111111