1111111111111111111111111111111111111111111111111
1000000000000000000000C00000000000010000100000001
1000000100000010000000100000000000000100000100001
1E1100001000111C000000110000000100101010100000X01
111100001010010C01P10100000000000X000000001110001
1111111111111111111111111111111111111111111111111