1111111111111111111111111111111111111111111111111111111111111111
1000000000000000000000C00000000000010000100000000000000000000001
1000000100000010000000100000000000000100000100000000000000000001
1E1100001000111C000000110000000100101010100000X00000000000000001
111100001010010C01P10100000000000X000000001110000000000000000001
1000001001000100010000100101000010010100001000000000000000000001
1001010101000000001010100000001000000000000101000000000000000001
1111111111111111111111111111111111111111111111111111111111111111