1111111111111
1000000000001
1011C000110X1
1P10110E000X1
1111111111111